XXXXXXXXXX
X  b   j Xjjj
X XXXXX  X
X  b  X  X
XXXXX X  X
b   X XXXX
XjX X j  X
X X XXXX X
XpX  b   X
XXXXXXXXXX
XXX