XXXXXXXXXX
X  b   j X
X XXXXX  X
X  b  X  X
XXXXX X  X
X   X XXXX
XjX X j  X
X X XXXX X
X X  b   X
XXXXXXXXXX