 - - - - - - - - - - 
|                   |
 -   - - - - - -   - 
| | |           | | |
 -   - -     - -   - 
|       |   |       |
   - -         - -   
| |   | |   | |   | |
   -     - -     -   
|   | |       | |   |
 -     - - - -     - 
|   | |       | |   |
   -     - -     -   
| |   | |   | |   | |
   - -         - -   
|       |   |       |
 -   - -     - -   - 
| | |           | | |
 -   - - - - - -   - 
|                   |
 - - - - - - - - - -